fntl : ForgeNamedTagLists
foom : forgeobjectmanifest
fpal : ForgePaletteDefinition
fosp : ForgeObjectScriptPropertyMenuIte
food : forgeobjectdata
sbnk : soundbank
matg : globals
curv : curvedefinition
bnch : benchmarkdefinition
angb : animglobals
attd : audiothreatglobals
cagg : cageglobalsdefinition
cage : cagedefinition
hsgd : highlightserviceglobalsdefinition
ostd : outlinetypedefinition
apdd : actionprioritydatadefinitiontag
glst : subtitleglobalsdefinition
uslg : stringlist
nagl : navigationglobals
atcg : asset_category_globals
osgd : outlineserviceglobalsdefinition
bitm : bitmap
sptg : spartantrackingglobalsdefinition
sptp : spartantrackingpingdefinition
glsa : skillrankingglobalsdefinition
glcm : composerglobalsdefinition
cmpt : composer_transition
cmpS : composer_spawning_pattern
glgo : gameplayobjectglobalsdefinition
glga : garbagecollectionglobalsdefinition
glin : interfaceglobalsdefinition
obcu : uiobjectcustomization
drdg : damagereportingdisplayglobals
wigl : user_interface_shared_globals_definition
cure : cui_resources
luas : lua_script
fnts : wpf_font_set
bitd : bitmap_dictionary
nphg : narrationphonemes
cusc : cui_screen
unic : multilingual_unicode_string_list
emth : emblem_theme_globals
snd! : sound
sndc : sound_category
musc : music_control
uise : user_interface_sounds_definition
sgrp : sound_response
fntf : typeface
dcgd : dispositioncolors
uisd : uiseasondata
plan : uiplatformanimations
ltps : uilightpresets
uiin : uiiteminspect
fafl : forwardfastlighting
caps : uicamerapresets
gllo : locglobalsdefinition
glma : materialglobalsdefinition
rwrd : render_water_ripple
effe : effect
pmov : particle_physics
efge : generator_system
shdv : shadervariant
shbc : shader_bytecode
shrs : shader_root_signature
prt3 : particle
wpdp : water_physics_drag_properties
glpa : playerglobalsdefinition
glsk : skullglobalsdefinition
glso : softceilingglobalsdefinition
gldi : difficultyglobalsdefinition
glda : damageglobalsdefinition
jpt! : damage_effect
desd : damage_effect_sounds
drdf : damage_response_definition
rmbl : rumble
csdt : camera_shake
glcn : controlglobalsdefinition
insc : inputscope
inbu : inputbundle
inmo : inputmode
inbs : inputbundleset
indb : inputdevicebindings
glco : colorglobalsdefinition
glch : cheatglobalsdefinition
glca : cameraglobalsdefinition
trak : camera_track
wgbl : weapon_globals
fogg : atmosphere_fog
cfdf : collisionfilterdefinition
LigS : lighting_settings
sggs : sound[11_model_animation_resource]
gptd : game_performance_throttle
lgtd : loadout_globals_definition
pmcg : player_model_customization_globals
grfr : grounded_friction
effg : effect_globals
cmoe : camo
lens : lens_flare
gldf : cheap_light
mfxg : materialeffectsglobals
pmdf : particle_model
sefc : area_screen_effect
mat  : material
cddf : collision_damage
wind : wind
cfxs : camera_fx_settings
efex : effect_exposure
rasg : rasterizer_globals
mwsw : materialswatch
hair : hair
exs* : explicitshaders
psod : psodictionary
mode : render_model
perf : performance_throttles
cptl : cheap_particle_type_library
sspg : sssprofile
gmeg : game_medal_globals
gggl : game_globals_grenade_list
proj : projectile
hlmt : model
mwsy : materialstyles
mwpl : materialpalette
cwms : coatingmaterialset
phmo : physics_model
foot : material_effects
coll : collision_model
stai : sound_tail
flni : flinch_impulse
mdsv : model_dissolve_definition
cpem : cheap_particle_emitter
efwi : effect_wind
decs : decal_system
prmr : projectilematerialresponse
lsnd : sound_looping
prjf : projectileflyby
intr : interaction
xong : xobjectnodegraph
ongc : objectnodegraph
eqip : equipment
fpal : forgepalettedefinition
hsc* : lua
motl : multiplayer_object_type_list
mulg : multiplayer_globals
weap : weapon
jmad : model_animation_graph
Rani : runtimeanimset
wcfg : weapon_configuration
sofd : framedefinition
sofa : frameattachmentdefinition
weme : weapon_attachment_melee
bloc : crate
scen : scenery
frms : frame_event_list
weab : weapon_attachment_barrel
trac : tracer_system
weam : weapon_attachment_magazine
west : weapon_attachment_sight
wdof : weapon_depth_of_field
weat : weapon_attachment
gmpm : genericmodifierdefinitiontag
scbd : supercombine
uiwi : uiweapondisplayinfodefinition
fele : frame_event_list_effect
ssdf : spawnsettings
siin : simulation_interpolation
ucnt : ucn_authority_trust_settings
ligh : light
pnai : personalaiglobalsdefinition
ssgd : spottingserviceglobals
gegl : game_engine_globals
forg : forge_globals
comp : composition
cmps : composition_scene
camg : camera_animation_graph
subt : composer_subtracks
aigl : ai_globals
form : formation
adlg : ai_dialogue_globals
dsdt : dialogue_system_data
sngl : sound_globals
ligr : lightgroup
cnvo : conversation
cnvt : conversationtypes
chrd : chroma_definition
chrm : chroma
cmpg : campaignglobalsdefinition
cole : collectiblesdefinition
uigm : gameplaymenuuiinfo
cmpu : campaignupgrades
valu : valorunlocks
phyg : physicsglobalsdefinition
ongg : objectnodegraph_globals
gfpd : graphicspresetdefinitions
narg : narrativeglobals
mglb : meleeglobals
toks : tokensystemglobalsdefinition
dwsg : dynamicworldstateglobals
embl : emblem
shdr : shader
texg : texturegroup
ghig : highlighteventsglobals
levl : level
sirp : scenario_interpolator
pfnd : pathfinding
dcpt : decorator_palette
angt : xanimnodegraph
ansm : xanimstategraph
tlgt : xtransitionlogicgraph
xbgt : xanimblendgraphng
stse : sound[0_model_animation_resource]
sssc : scenario_sound_constants
rtrn : runtime_terrain
dcrt : runtime_dec
hlds : hlodsystem
sred : scenario_render_data
hscn : script_container
vehi : vehicle
sadt : spring_acceleration
trds : trackdecalsystem
ant! : antenna
tccg : terrain_cell_geo
GobS : gobo_setting
bipd : biped
fela : frame_event_list_audio
udlg : dialogue
pugm : powerupdefinition
bdpd : death_program_selector
plcc : lowceilingcontroltag
spab : spartanabilitycomponentdefinition
mwvs : materialvisorswatch
flns : flinch_system
pbfx : propertybasedeffectstag
phcc : clamberingdefinition
licn : light_cone
walt : weaponcomponentaltfire
ltvl : light_volume_system
wett : weapon_attachment_target_tracking
sbsp : scenario_structure_bsp
scgt : static_collision
rtgo : runtime_geo
smet : structure_meta
ngst : node_graph_stack
stlm : structure_lightmap
flck : flock
crea : creature
font : wpf_font
wgtz : user_interface_globals_definition
ocgd : customizationglobalsdefinition
char : character
styl : style
beht : behaviortree
sasp : sprintdefinitiontag
sagh : grapplehookdefinitiontag
saev : evadedefinitiontag
mead : meleeadditionaldamage
